,A,B,Distance,PassagersAtoB,PassagersBtoA,PassagersTotal,EurotramAtoB,EurotamBtoA,EurotramTotal,TraintramAtoB,TraintramBtoA,TraintramTotal,OccupancyAtoB,OccupancyBtoA,OccupancyTotal
3,Fânzeres,Venda Nova,440.45,238,155,393,40,40,80,0,0,0,0.0275462962962963,0.01798351773383473,0.022764907015065516
4,Venda Nova,Carreira,583.47,296,304,601,40,40,80,0,0,0,0.03430749546903614,0.03527252479299059,0.03479001013101337
5,Carreira,Baguim,786.02,347,375,722,40,40,80,0,0,0,0.04016628283739083,0.04345969183754635,0.04181298733746859
6,Baguim,Campainha,751.7,368,418,787,40,40,80,0,0,0,0.042697694099407366,0.04848301017891913,0.04559035213916325
7,Campainha,Rio Tinto,859.99,421,519,940,40,40,80,0,0,0,0.04874472178818068,0.06016146079564689,0.05445309129191379
8,Rio Tinto,Levada,452.83,435,615,1051,40,40,80,0,0,0,0.05038085943155506,0.07128198567024235,0.06083142255089871
9,Levada,Nau Vitória,1111.62,738,655,1394,40,40,80,0,0,0,0.08548559225372501,0.07590905372451873,0.08069732298912187
10,Nau Vitória,Nasoni,499.02,751,682,1433,40,40,80,0,0,0,0.08698974049788351,0.07893555064203674,0.08296264556996012
11,Nasoni,Contumil,650.0,778,686,1464,40,40,80,0,0,0,0.09008391518369736,0.07945748723380501,0.08477070120875119
12,Contumil,Estádio do Dragão,619.19,797,808,1606,40,40,80,0,0,0,0.09229022754769858,0.09360841660465984,0.09294932207617922
13,Estádio do Dragão,Campanhã,1166.02,1268,1359,2628,40,60,100,40,60,100,0.0683623729870045,0.04882191957797128,0.056638100941584564
14,Campanhã,Heroismo,950.92,2448,2462,4910,60,60,120,64,120,184,0.08493095029682322,0.05763569994614557,0.06863436746222812
15,Heroismo,24 de Agosto,571.9,2569,2640,5209,61,60,121,80,120,200,0.07782351065609933,0.061805819223832645,0.06878849721485035
16,24 de Agosto,Bolhão,680.44,3320,3326,6646,53,60,113,80,120,200,0.1061228513874839,0.07785677781020571,0.08980668741573321
17,Bolhão,Trindade,451.8,3898,3997,7895,42,60,102,80,120,200,0.13484166337165476,0.09356290092259305,0.11022377287824517
18,Trindade,Lapa,857.4300000000001,5552,5832,11384,148,181,329,80,120,200,0.10717523777833138,0.08469877935053766,0.09434921658307709
19,Lapa,Carolina Michaelis,460.97,5450,5926,11377,160,180,340,80,120,200,0.10020149162740687,0.08633511369483873,0.09246589197451777
20,Carolina Michaelis,Casa da Música,627.48,5138,5915,11053,160,172,332,80,120,200,0.09445107955593005,0.08840585219088688,0.09111671648014391
21,Casa da Música,Francos,871.87,4627,5421,10049,160,161,321,80,120,200,0.08507207795535068,0.0840046942250475,0.08449290363959393
22,Francos,Ramalde,965.03,4331,5079,9411,180,160,340,80,120,200,0.07376434946370944,0.07897606653652262,0.07648881014416574
23,Ramalde,Viso,621.15,4003,5068,9072,180,160,340,80,120,200,0.06817508871466868,0.07880802226187626,0.07373352731802037
24,Viso,Sete Bicas,743.81,3704,4970,8675,180,160,340,80,119,199,0.06309345004011631,0.07757850391959518,0.07065164904466034
25,Sete Bicas,Sra da Hora,674.5,3832,3139,6972,180,160,340,80,100,180,0.06526280893105567,0.05289459534360032,0.059045183943324045
26,Sra da Hora,Vasco da Gama,824.48,1037,654,1692,120,120,240,0,0,0,0.04002067467639665,0.025258526513677066,0.03263960059503686
27,Vasco da Gama,Estádio do Mar,661.6,890,686,1576,120,118,238,0,0,0,0.034337234237748634,0.0269459336338632,0.030672639820696193
28,Estádio do Mar,Pedro Hispano,786.97,860,666,1527,120,101,221,0,0,0,0.033215283845216756,0.030570024560203874,0.032006364443468785
29,Pedro Hispano,Parque de Real,656.68,800,655,1456,122,101,223,0,0,0,0.030380336575830124,0.030052483766167058,0.030231847186700214
30,Parque de Real,C. Matosinhos,723.67,703,619,1323,133,100,233,0,0,0,0.024484412989391094,0.028698845494185735,0.026293182304753603
31,C. Matosinhos,Matosinhos Sul,616.61,502,515,1018,133,95,228,0,0,0,0.017484957481025663,0.025138387859654773,0.02067388680545446
32,Matosinhos Sul,Brito Capelo,535.72,270,266,536,126,90,216,0,0,0,0.009925206067630553,0.01368408685592814,0.011491406396087882
33,Brito Capelo,Mercado,487.53,120,182,303,126,90,216,0,0,0,0.004439794529869644,0.009371681675540915,0.006494747507232675
34,Mercado,Sr. de Matosinhos,708.96,22,20,42,126,110,236,0,0,0,0.0008361525295812147,0.0008417508417508417,0.0008387619123721425
35,Sra da Hora,Fonte do Cuco,687.03,1566,1987,3554,60,40,100,40,53,93,0.06847530014672745,0.09123191221380725,0.07957439644955
36,Fonte do Cuco,Custoias,689.2,1517,1992,3509,60,40,100,42,43,85,0.06492347412970291,0.10320194638587642,0.0822366800442571
37,Custoias,Esposade,1779.24,1490,1990,3481,60,40,100,60,40,100,0.05355156069526761,0.10724000806700856,0.075026939643964
38,Esposade,Crestins,2035.56,1456,1930,3387,60,40,100,60,40,100,0.052325662625341725,0.10403067045219815,0.0730076657560843
39,Crestins,Verdes,591.8199999999999,1415,1908,3323,60,40,100,60,40,100,0.05082928256251402,0.10284811832359814,0.07163681686694766
40,Verdes,Pedras Rubras,960.78,981,775,1756,0,0,0,60,40,100,0.06597317166689867,0.07815019607624121,0.07084398143063568
41,Pedras Rubras,Lidador,1147.58,868,769,1638,0,0,0,60,40,100,0.05836936605357385,0.07760882747599852,0.06606515062254373
42,Lidador,Vilar do Pinheiro,1987.51,849,763,1612,0,0,0,60,40,100,0.05706744430806147,0.07695201124325564,0.06502127108213913
43,Vilar do Pinheiro,Modivas Sul,2037.38,809,765,1575,0,0,0,67,47,114,0.04872162061602983,0.06571481139903151,0.055727585237091926
44,Modivas Sul,Modivas Centro,1051.08,798,767,1565,0,0,0,67,47,114,0.04803973797656246,0.06580971138890868,0.05536595508516134
45,Modivas Centro,Modivas Norte,852.51,784,770,1555,0,0,0,67,47,114,0.04722412219098358,0.06608825194875288,0.0550014388455025
46,Modivas Norte,Mindelo,1834.12,761,738,1499,0,0,0,66,47,113,0.04649671016360982,0.06336830976731861,0.053514101149223205
47,Mindelo,Espaço Natureza,776.86,735,706,1441,0,0,0,66,47,113,0.044905375689665336,0.06064135142350975,0.05145042754356523
48,Espaço Natureza,Varziela,1539.0,731,673,1405,0,0,0,66,53,119,0.04466600324109939,0.0512746934069434,0.047609369449416475
49,Varziela,Árvore,858.71,668,647,1316,0,0,0,60,60,120,0.04491607021108435,0.043539272777552686,0.04422767149431852
50,Árvore,Azurara,664.57,667,644,1311,0,0,0,61,60,121,0.044097348763185544,0.043292184788857276,0.043698093899882266
51,Azurara,Santa Clara,1218.09,647,632,1280,0,0,0,61,41,102,0.042805831607515325,0.06221724461538913,0.05060845840479793
52,Santa Clara,Vila do Conde,670.57,632,558,1191,0,0,0,76,40,116,0.03355723112643824,0.056350469424563135,0.04141696847061924
53,Vila do Conde,Alto de Pega,730.41,481,429,911,0,0,0,80,40,120,0.02429094584666355,0.04334156251685943,0.030641151403395513
54,Alto de Pega,Portas Fronhas,671.05,467,368,835,0,0,0,80,40,120,0.02354588891684288,0.037125928801262024,0.02807256887831593
55,Portas Fronhas,São Brás,562.21,341,254,596,0,0,0,80,40,120,0.017187879244428658,0.025705524497204535,0.02002709432868728
56,São Brás,Póvoa de Varzim,624.94,323,219,543,0,0,0,82,40,122,0.015928569975948798,0.022177419354838707,0.01797737305099467
57,Sra da Hora,Fonte do Cuco,685.98,1023,602,1625,0,0,0,40,40,80,0.10320049662303049,0.060704999345122024,0.08195274798407624
58,Fonte do Cuco,Cândido dos Reis,913.51,956,608,1564,0,0,0,40,40,80,0.09640078693031547,0.061308243439417126,0.07885451518486629
59,Cândido dos Reis,Pias,916.73,897,618,1516,0,0,0,40,40,80,0.09046783550176307,0.06239761758661776,0.07643272654419041
60,Pias,Araújo,1258.13,880,618,1499,0,0,0,40,40,80,0.08879517616301749,0.06234545794542807,0.07557031705422278
61,Araújo,Custió,651.69,834,589,1424,0,0,0,40,40,80,0.08416804699783004,0.05939899583873604,0.07178352141828305
62,Custió,Parque de Maia,1418.51,752,592,1344,0,0,0,40,40,80,0.07581770145445961,0.059689291884928775,0.06775349666969419
63,Parque de Maia,Forum,824.81,700,562,1262,0,0,0,57,40,97,0.04955091144387859,0.05669199007516389,0.05249568613719211
64,Forum,Zona Industrial,1119.4,244,413,658,0,0,0,60,40,100,0.016449489878667133,0.041703271824576504,0.02655100265703088
65,Zona Industrial,Mandim,1194.23,211,373,585,0,0,0,60,40,100,0.01421841354709427,0.03769537379180726,0.02360919764497947
66,Mandim,Castêlo da Maia,1468.1,206,341,548,0,0,0,60,40,100,0.01390924587657419,0.034469981086780135,0.02213353996065657
67,Castêlo da Maia,ISMAI,702.48,107,205,313,0,0,0,60,59,119,0.007230907962256666,0.0140787315472936,0.010626047386770775
68,Santo Ovídio,D. João II,463.71,765,1048,1813,100,120,220,0,0,0,0.03541666666666668,0.040462219923485046,0.03816878662493124
69,D. João II,João de Deus,716.25,1045,1561,2606,100,120,220,0,0,0,0.048395396242656416,0.060224791070569675,0.054847793421518194
70,João de Deus,C.M.Gaia,405.01,1574,2505,4080,100,120,220,0,0,0,0.0728782568275137,0.09667808323703102,0.08585998032361405
71,C.M.Gaia,General Torres,488.39,1662,3005,4668,100,120,220,0,0,0,0.0769770903899636,0.11595013608658403,0.09823511531539292
72,General Torres,Jardim do Morro,419.98,1714,3400,5114,100,120,220,0,0,0,0.07937481629070277,0.13118939554823283,0.10763731406753735
73,Jardim do Morro,São Bento,795.7,1824,3581,5406,100,120,220,0,0,0,0.08447842597829568,0.1381773391656099,0.11376874226228526
74,São Bento,Aliados,443.38,3073,3631,6704,100,100,200,0,0,0,0.14230463895070192,0.1681103216100756,0.15520748028038875
75,Aliados,Trindade,450.27,4033,3389,7422,100,100,200,0,0,0,0.1867293344098786,0.15690203385354165,0.17181568413171014
76,Trindade,Faria Guimaraes,555.34,3638,1978,5616,120,100,220,0,0,0,0.14036703333618947,0.09157424911867239,0.11818849505549989
77,Faria Guimaraes,Marques,621.04,3413,1950,5364,120,100,220,0,0,0,0.1317096343262104,0.09030830388845969,0.11289084776359645
78,Marques,Combatentes,702.75,2485,1694,4180,120,100,220,0,0,0,0.09588229006142021,0.0784682747833005,0.08796682857136578
79,Combatentes,Salgueiros,471.25,2039,1572,3612,120,100,220,0,0,0,0.0786843971045154,0.07280733455917063,0.0760130050384496
80,Salgueiros,Polo Universitario,775.36,1611,1393,3004,120,100,220,0,0,0,0.062177328646236374,0.06449731785824155,0.06323186919714781
81,Polo Universitario,I.P.O.,827.64,1251,1169,2420,122,100,222,0,0,0,0.0474915237070474,0.054132766530275836,0.05048307452832147
82,I.P.O.,Hospital São João,351.77,805,967,1772,122,100,222,0,0,0,0.030548135451228187,0.04476851851851852,0.03695371340946707
83,Verdes (E) ,Botica,683.54,462,1170,1632,60,40,100,0,0,0,0.0356592441226732,0.1354440056952435,0.07557314875170132
84,Botica,Aeroporto,649.66,433,1042,1475,61,80,141,0,0,0,0.032894831577483255,0.060300925925925924,0.04844438865461385
