,A,B,Distance,PassagersAtoB,PassagersBtoA,PassagersTotal,EurotramAtoB,EurotramBtoA,EurotramTotal,TraintramAtoB,TraintramBtoA,TraintramTotal,OccupancyAtoB,OccupancyBtoA,OccupancyTotal
0,Fânzeres,Venda Nova,440.45,578,787,1366,163,159,322,0,0,0,0.016445126107702775,0.022929266775560044,0.019646922275992545
1,Venda Nova,Carreira,583.47,1117,1547,2664,163,159,322,0,0,0,0.03173503535073848,0.0450517260902926,0.03831066835567359
2,Carreira,Baguim,786.02,1536,1930,3467,163,159,322,0,0,0,0.043653022291407786,0.05619947775500099,0.04984832172839946
3,Baguim,Campainha,751.7,1921,2128,4049,163,161,324,0,0,0,0.054562651275306594,0.06120795793082705,0.0578647943973399
4,Campainha,Rio Tinto,859.99,2726,2509,5236,160,157,317,0,0,0,0.07890084569906214,0.07399964928916505,0.07647343927523298
5,Rio Tinto,Levada,452.83,3064,2961,6026,160,157,317,0,0,0,0.08866960174461147,0.08733224264751344,0.08800725039368279
6,Levada,Nau Vitória,1111.62,3829,3923,7752,160,157,317,0,0,0,0.11079565398642774,0.11568852040764728,0.11321893483226833
7,Nau Vitória,Nasoni,499.02,4109,4023,8133,160,157,317,0,0,0,0.11891095369470359,0.11864728898751982,0.1187803689659091
8,Nasoni,Contumil,650.0,4324,4115,8439,160,157,317,0,0,0,0.1251169019424773,0.12136896373974856,0.1232606675644697
9,Contumil,Estádio do Dragão,619.19,5218,4982,10201,160,157,317,0,0,0,0.15100611488364168,0.1469223675387192,0.14898356493678735
10,Estádio do Dragão,Campanhã,1166.02,9421,9354,18776,237,238,475,168,159,327,0.10146757358747961,0.10297406137111449,0.10221255088837562
11,Campanhã,Heroismo,950.92,18461,18927,37388,326,317,643,230,237,467,0.1448427499374933,0.14874626381618658,0.14679291300535233
12,Heroismo,24 de Agosto,571.9,20480,20678,41158,329,310,639,232,237,469,0.1592591086014605,0.16445594380858045,0.1618282662181661
13,24 de Agosto,Bolhão,680.44,28379,26462,54842,331,315,646,232,237,469,0.21994340369608686,0.20867230743051554,0.21435666725876978
14,Bolhão,Trindade,451.8,34685,35925,70610,335,323,658,232,237,469,0.2670250931544615,0.2794792760584137,0.273219608272886
15,Trindade,Lapa,857.4300000000001,39132,50846,89979,323,319,642,232,242,474,0.3073924134336587,0.39440526075691223,0.3511732312997206
16,Lapa,Carolina Michaelis,460.97,38778,49579,88357,329,319,648,235,240,475,0.2998069429563011,0.3860623639882834,0.34278072632200707
17,Carolina Michaelis,Casa da Música,627.48,37386,45312,82699,329,319,648,235,244,479,0.28904594026488417,0.35013331336577946,0.31959812559965567
18,Casa da Música,Francos,871.87,33666,37121,70788,329,291,620,228,267,495,0.2638294743928423,0.2876047201422875,0.27578489951117013
19,Francos,Ramalde,965.03,31334,33229,64563,323,280,603,230,272,502,0.24709868199378726,0.2597322290634384,0.25344342604233355
20,Ramalde,Viso,621.15,29322,31859,61181,335,280,615,228,272,500,0.22747453611524326,0.24902462131423372,0.2382089688360735
21,Viso,Sete Bicas,743.81,27812,30028,57840,323,286,609,228,272,500,0.22018702281866023,0.23235783394166798,0.22634196389749026
22,Sete Bicas,Sra da Hora,674.5,24346,28322,52668,323,275,598,226,271,497,0.19350821035457258,0.22370173503330987,0.20865233996398203
23,Sra da Hora,Vasco da Gama,824.48,9359,9121,18481,161,162,323,0,0,0,0.2691482484602961,0.2606626302809056,0.26489230373874423
24,Vasco da Gama,Estádio do Mar,661.6,9397,8835,18232,161,162,323,0,0,0,0.2702229432495254,0.25248858173380984,0.2613283099196618
25,Estádio do Mar,Pedro Hispano,786.97,9260,8804,18064,161,162,323,0,0,0,0.26627695103102866,0.2516189559346092,0.25892526308793284
26,Pedro Hispano,Parque de Real,656.68,8431,8205,16637,161,162,323,0,0,0,0.242456045615849,0.23449487866707175,0.23846313835361396
27,Parque de Real,C. Matosinhos,723.67,8116,7383,15500,157,162,319,0,0,0,0.2393500766510084,0.21101653799057293,0.22496125764476843
28,C. Matosinhos,Matosinhos Sul,616.61,6156,5117,11274,162,169,331,0,0,0,0.17595324854734648,0.14019294836113871,0.15769496839185065
29,Matosinhos Sul,Brito Capelo,535.72,3095,2643,5738,160,166,326,0,0,0,0.08956936606353798,0.07371445018935825,0.08149600399263664
30,Brito Capelo,Mercado,487.53,1661,1479,3141,160,166,326,0,0,0,0.048069615762156535,0.04127101657408112,0.04460775237190954
31,Mercado,Sr. de Matosinhos,708.96,670,444,1115,160,166,326,0,0,0,0.01938790892842455,0.012410754127621595,0.015835124582003413
33,Fonte do Cuco,Custoias,689.2,8989,12545,21534,78,81,159,164,166,330,0.15628220860312161,0.21384678422643316,0.1853478997857797
34,Custoias,Esposade,1779.24,8755,12290,21046,78,81,159,168,160,328,0.14963784043258982,0.21495816041189234,0.18192083102052115
35,Esposade,Crestins,2035.56,8658,12160,20818,78,81,159,168,166,334,0.14797413850497956,0.20729346558113765,0.17767227637959326
36,Crestins,Verdes,591.8199999999999,8633,12041,20675,85,81,166,168,166,334,0.14383457468148442,0.20526628013113896,0.17419846630067534
37,Verdes,Pedras Rubras,960.78,6521,6808,13329,0,0,0,168,166,334,0.156516798693229,0.16537534193120246,0.1609195477276709
38,Pedras Rubras,Lidador,1147.58,5908,5921,11829,0,0,0,166,166,332,0.1435096157009106,0.14384941926153677,0.1436795174812237
39,Lidador,Vilar do Pinheiro,1987.51,5581,5699,11281,0,0,0,166,166,332,0.13558592716081053,0.13844433826900227,0.1370151327149064
40,Vilar do Pinheiro,Modivas Sul,2037.38,5443,5627,11071,0,0,0,164,166,330,0.13384428468681703,0.1367040283149083,0.13528282239064474
41,Modivas Sul,Modivas Centro,1051.08,5385,5584,10970,0,0,0,162,166,328,0.13404709874681559,0.13565726692145486,0.13486200093276107
42,Modivas Centro,Modivas Norte,852.51,5323,5522,10845,0,0,0,162,168,330,0.1325110535472606,0.13253655412057502,0.13252403565731155
43,Modivas Norte,Mindelo,1834.12,4601,5332,9934,0,0,0,164,168,332,0.11314710651581611,0.1279897070155837,0.1206578200217226
44,Mindelo,Espaço Natureza,776.86,4436,5167,9604,0,0,0,158,168,326,0.11323285212641088,0.12403732318854976,0.11880080040383213
45,Espaço Natureza,Varziela,1539.0,4426,5141,9567,0,0,0,154,168,322,0.11590627306867397,0.12339567967517574,0.11981378955902273
46,Varziela,Árvore,858.71,4115,4937,9052,0,0,0,170,168,338,0.09760575987486597,0.11851054589101365,0.1079963044036021
47,Árvore,Azurara,664.57,4111,4919,9031,0,0,0,168,168,336,0.09868354527179964,0.11808416947246726,0.10838385737213344
48,Azurara,Santa Clara,1218.09,4047,4814,8862,0,0,0,170,168,338,0.09601189494578274,0.1155584108086822,0.10572732294864401
49,Santa Clara,Vila do Conde,670.57,3941,4639,8580,0,0,0,176,170,346,0.09029894953120726,0.11004258433063252,0.09999957934595378
50,Vila do Conde,Alto de Pega,730.41,2804,3248,6052,0,0,0,174,168,342,0.06499052243492094,0.07796521279933304,0.07136405454375494
51,Alto de Pega,Portas Fronhas,671.05,2654,2997,5651,0,0,0,168,168,336,0.06370252962192251,0.07193944918330486,0.06782098940261369
52,Portas Fronhas,São Brás,562.21,2046,2415,4461,0,0,0,168,168,336,0.04912128012865857,0.0579668081904414,0.05354404415954998
53,São Brás,Póvoa de Varzim,624.94,1946,2287,4233,0,0,0,168,167,335,0.04672443220261252,0.055220204751786774,0.05095963821966356
55,Fonte do Cuco,Cândido dos Reis,913.51,6232,7213,13445,83,39,122,70,114,184,0.1766041202104345,0.19656244295254352,0.18677847300194975
56,Cândido dos Reis,Pias,916.73,5869,6961,12831,83,39,122,70,114,184,0.16634153190126882,0.18970992338754344,0.1782542693704333
57,Pias,Araújo,1258.13,5565,6704,12270,83,39,122,70,112,182,0.15770723456219035,0.1852194691055751,0.1716388439297839
58,Araújo,Custió,651.69,5366,6510,11876,83,72,155,70,78,148,0.15206305564469522,0.1865741104641285,0.16922220543637057
59,Custió,Parque de Maia,1418.51,5093,6151,11245,83,74,157,70,78,148,0.1443290419765456,0.17413941908427757,0.15924267348303076
60,Parque de Maia,Forum,824.81,4462,5514,9977,83,74,157,70,78,148,0.12646729172839813,0.15609573944339553,0.14128990701212177
61,Forum,Zona Industrial,1119.4,2337,3616,5954,81,73,154,72,77,149,0.0661343240896001,0.10372087504011045,0.08479698662148161
62,Zona Industrial,Mandim,1194.23,2178,3559,5738,52,73,125,77,77,154,0.07182946410116328,0.10210129963519332,0.08801852524453094
63,Mandim,Castêlo da Maia,1468.1,2139,3457,5596,44,73,117,106,77,183,0.059764156755890974,0.09916676466872862,0.07920670264404162
64,Castêlo da Maia,ISMAI,702.48,1287,2270,3558,44,71,115,106,84,190,0.03596745406341655,0.0627903118779031,0.04944895936406065
65,Santo Ovídio,D. João II,463.71,8658,7125,15784,376,378,754,0,0,0,0.10661692277383765,0.08727182945916707,0.09691871949406912
66,D. João II,João de Deus,716.25,11973,10498,22472,380,374,754,0,0,0,0.14587883124692547,0.12996021850520778,0.13798286153153766
67,João de Deus,C.M.Gaia,405.01,18959,16442,35401,396,382,778,0,0,0,0.22165122172721335,0.19927208298998678,0.2106630070773155
68,C.M.Gaia,General Torres,488.39,21764,18747,40512,374,408,782,0,0,0,0.2694178523195629,0.21273557743301566,0.23984449150919046
69,General Torres,Jardim do Morro,419.98,23835,20657,44492,374,380,754,0,0,0,0.2950506344364241,0.25167579629414716,0.2731906364336851
70,Jardim do Morro,São Bento,795.7,24434,22159,46593,390,376,766,0,0,0,0.2900562272841986,0.27284570337803754,0.28160824165924225
71,São Bento,Aliados,443.38,29768,31278,61047,374,396,770,0,0,0,0.36849748556692,0.3656809533767554,0.3670489832976925
72,Aliados,Trindade,450.27,31609,34814,66424,374,406,780,0,0,0,0.3912822897152363,0.3969945275756488,0.39425558275539974
73,Trindade,Faria Guimaraes,555.34,30146,34109,64255,378,374,752,0,0,0,0.3692230722476765,0.4222318717100449,0.3955864911292267
74,Faria Guimaraes,Marques,621.04,28888,32751,61639,410,374,784,0,0,0,0.32619935173391534,0.4054187783515737,0.36399025167652277
75,Marques,Combatentes,702.75,24176,23705,47882,382,392,774,0,0,0,0.2930117790948356,0.27996433079943445,0.28640376910543347
76,Combatentes,Salgueiros,471.25,21878,21135,43014,376,410,786,0,0,0,0.26939238632498846,0.2386622489155594,0.253362670882411
77,Salgueiros,Polo Universitario,775.36,20013,19113,39126,376,376,752,0,0,0,0.24642009096491804,0.235337154865331,0.24087862291512455
78,Polo Universitario,I.P.O.,827.64,15131,15458,30590,392,376,768,0,0,0,0.178707311071834,0.19034204102413718,0.18440348094431575
79,I.P.O.,Hospital São João,351.77,6509,7346,13856,376,418,794,0,0,0,0.08015607073554995,0.0813729399255715,0.08079668952828169
80,Verdes (E) ,Botica,683.54,2311,5546,7858,83,83,166,0,0,0,0.12894736819378255,0.30939512322876445,0.21917124571127353
81,Botica,Aeroporto,649.66,2165,5350,7516,83,83,166,0,0,0,0.12077173924080556,0.29847166443551976,0.20962170183816267
82,Sra da Hora,Fonte do Cuco,687.03,16241,20715,36957,161,120,281,226,280,226,0.1826919721086455,0.21415132296112496,0.19856081255520064
