,A,B,Distance,PassagersAtoB,PassagersBtoA,PassagersTotal,EurotramAtoB,EurotamBtoA,EurotramTotal,TraintramAtoB,TraintramBtoA,TraintramTotal,OccupancyAtoB,OccupancyBtoA,OccupancyTotal
3,Fânzeres,Venda Nova,440.45,93,368,461,42,82,124,0,0,0,0.010251322751322756,0.02079293585851618,0.01722238948349905
4,Venda Nova,Carreira,583.47,160,676,836,42,81,123,0,0,0,0.01767339662358491,0.03866157943384148,0.031494882864485575
5,Carreira,Baguim,786.02,222,953,1176,42,60,102,0,0,0,0.02453383665690217,0.07360894901251964,0.053401549807265386
6,Baguim,Campainha,751.7,258,1074,1332,42,44,86,0,0,0,0.028442744820050037,0.11307755831777727,0.07174427730725932
7,Campainha,Rio Tinto,859.99,365,1401,1766,42,44,86,0,0,0,0.040304503093553795,0.14743130764550633,0.09511356588757601
8,Rio Tinto,Levada,452.83,422,1678,2100,42,42,84,0,0,0,0.046560966657476895,0.18497132208823666,0.11576614437285679
9,Levada,Nau Vitória,1111.62,744,2064,2809,42,42,84,0,0,0,0.08211874201726319,0.22762316051286816,0.15487095126506567
10,Nau Vitória,Nasoni,499.02,762,2148,2910,42,42,84,0,0,0,0.08400967519040346,0.23683376806603174,0.1604217216282176
11,Nasoni,Contumil,650.0,801,2183,2984,42,42,84,0,0,0,0.08829545319970698,0.24072597399051732,0.16451071359511213
12,Contumil,Estádio do Dragão,619.19,959,2497,3457,42,42,84,0,0,0,0.10572783008809507,0.27534054775324823,0.19053418892067164
13,Estádio do Dragão,Campanhã,1166.02,2324,4130,6454,125,151,276,84,84,168,0.04859109883166426,0.07728523953884515,0.063733717636141
14,Campanhã,Heroismo,950.92,5127,7152,12279,145,147,292,125,126,251,0.08227349547128969,0.11353194752588,0.09798752738510384
15,Heroismo,24 de Agosto,571.9,5452,7810,13262,145,147,292,125,126,251,0.08748768583480272,0.123979733279419,0.10583271447357406
16,24 de Agosto,Bolhão,680.44,7482,9531,17014,145,147,292,125,126,251,0.1200702471904905,0.15129129132660016,0.13576547365533978
17,Bolhão,Trindade,451.8,10744,10905,21649,145,154,299,125,126,251,0.17240344746021188,0.16904671046557163,0.170696072215808
18,Trindade,Lapa,857.4300000000001,15493,15113,30607,165,187,352,125,114,239,0.2324953313809373,0.22011511568811373,0.2262126262847684
19,Lapa,Carolina Michaelis,460.97,15362,15011,30373,166,188,354,126,106,232,0.22893118493943554,0.22439870288487263,0.2266684616594203
20,Carolina Michaelis,Casa da Música,627.48,14808,14093,28902,167,199,366,126,105,231,0.21997080016221565,0.2041873629151391,0.21198045242016456
21,Casa da Música,Francos,871.87,14064,10936,25001,167,196,363,146,105,251,0.194583187205208,0.1599527322879081,0.17774855529881725
22,Francos,Ramalde,965.03,13066,9946,23013,152,190,342,146,105,251,0.18925469644235968,0.1482837697130907,0.16906420448673698
23,Ramalde,Viso,621.15,12220,9735,21956,166,173,339,142,105,247,0.17195109612916032,0.15353541804380605,0.1632680107927821
24,Viso,Sete Bicas,743.81,11734,9316,21050,166,169,335,125,104,229,0.175517119378379,0.14954698407588976,0.1629905185607078
25,Sete Bicas,Sra da Hora,674.5,10608,7360,17969,176,169,345,125,102,227,0.15371544417427957,0.1191099244458517,0.1373671296010099
26,Sra da Hora,Vasco da Gama,824.48,2961,3114,6075,84,126,210,0,0,0,0.16319863558845488,0.11442687109330611,0.13393557689136562
27,Vasco da Gama,Estádio do Mar,661.6,2683,3125,5808,84,126,210,0,0,0,0.14787361552226125,0.11482894598734997,0.12804681380131447
28,Estádio do Mar,Pedro Hispano,786.97,2633,3082,5716,84,139,223,0,0,0,0.14514233396703666,0.10267333114230166,0.11867062368614803
29,Pedro Hispano,Parque de Real,656.68,2451,3024,5475,80,105,185,0,0,0,0.14185802595934063,0.13333726687951744,0.13702191945457612
30,Parque de Real,C. Matosinhos,723.67,2298,2908,5206,64,105,169,0,0,0,0.16624237369099648,0.12822308590543707,0.14262092269996846
31,C. Matosinhos,Matosinhos Sul,616.61,1687,2280,3968,84,105,189,0,0,0,0.09299849975363506,0.10057222401972482,0.09720612434590714
32,Matosinhos Sul,Brito Capelo,535.72,836,828,1665,84,105,189,0,0,0,0.04610059023107514,0.03653515210324921,0.04078645793783851
33,Brito Capelo,Mercado,487.53,479,512,991,84,105,189,0,0,0,0.026429375332923128,0.0225833787015549,0.024292710537718556
34,Mercado,Sr. de Matosinhos,708.96,124,107,231,84,105,189,0,0,0,0.00684765661739704,0.004717813051146384,0.005664410191702231
35,Sra da Hora,Fonte do Cuco,687.03,3759,3270,7030,42,42,84,63,67,130,0.15224314964419675,0.12732771888498473,0.13954015692145463
36,Fonte do Cuco,Custoias,689.2,3580,3262,6842,42,42,84,68,81,149,0.13804560378111408,0.11187845289629622,0.12419642925299428
37,Custoias,Esposade,1779.24,3478,3198,6676,42,42,84,62,64,126,0.14226606476281847,0.12822789949431168,0.13517649571403256
38,Esposade,Crestins,2035.56,3419,3165,6585,42,42,84,63,63,126,0.13848097417864408,0.12816739953788872,0.1333241868582664
39,Crestins,Verdes,591.8199999999999,3400,3140,6540,42,42,84,63,63,126,0.13768300554540583,0.1271475506993946,0.13241527812240023
40,Verdes,Pedras Rubras,960.78,2567,1219,3787,0,0,0,63,63,126,0.16435961069343027,0.07806783829476105,0.12121372449409566
41,Pedras Rubras,Lidador,1147.58,2325,1126,3452,0,0,0,63,63,126,0.14886462083472296,0.07212043512025657,0.11049252797748976
42,Lidador,Vilar do Pinheiro,1987.51,2243,1087,3331,0,0,0,63,53,116,0.14358866074592008,0.08274834518213868,0.11579093035901997
43,Vilar do Pinheiro,Modivas Sul,2037.38,2194,1091,3286,0,0,0,63,42,105,0.14047988686793403,0.10480586842066363,0.12621027948902588
44,Modivas Sul,Modivas Centro,1051.08,2170,1099,3270,0,0,0,63,42,105,0.13893855502742616,0.10559154231604131,0.12559974994287224
45,Modivas Centro,Modivas Norte,852.51,2177,1106,3283,0,0,0,63,42,105,0.13934392691786374,0.1062113872964805,0.12609091106931045
46,Modivas Norte,Mindelo,1834.12,2003,793,2797,0,0,0,63,42,105,0.12823227008941718,0.07620592661378978,0.10742173269916622
47,Mindelo,Espaço Natureza,776.86,1863,787,2650,0,0,0,65,42,107,0.11558150773264378,0.07558873054510432,0.09988340827585258
48,Espaço Natureza,Varziela,1539.0,1856,779,2635,0,0,0,69,42,111,0.1084841321658188,0.0747946267624822,0.09573675174293468
49,Varziela,Árvore,858.71,1735,752,2487,0,0,0,84,42,126,0.08332069626425373,0.07219813188462074,0.07961317480437606
50,Árvore,Azurara,664.57,1740,742,2482,0,0,0,84,42,126,0.08352866834542112,0.07128638902549007,0.07944790857211077
51,Azurara,Santa Clara,1218.09,1686,738,2425,0,0,0,83,50,133,0.08195597325291384,0.059527892553894096,0.07352436396756808
52,Santa Clara,Vila do Conde,670.57,1626,710,2337,0,0,0,75,42,117,0.08742457854969499,0.06825793416506686,0.0805442446680336
53,Vila do Conde,Alto de Pega,730.41,1253,495,1748,0,0,0,83,42,125,0.06087682336809092,0.04760349790243175,0.05641698601162944
54,Alto de Pega,Portas Fronhas,671.05,1228,432,1661,0,0,0,105,42,147,0.047180698048605564,0.041555110805657554,0.045573387407763274
55,Portas Fronhas,São Brás,562.21,978,366,1345,0,0,0,105,42,147,0.03757130312075313,0.03520654852111879,0.03689565894942903
56,São Brás,Póvoa de Varzim,624.94,946,341,1287,0,0,0,105,42,147,0.03636122541468707,0.03273809523809526,0.03532604536423228
57,Sra da Hora,Fonte do Cuco,685.98,2748,1415,4163,0,0,0,42,42,84,0.26388508034453184,0.13587904197008194,0.1998820611573069
58,Fonte do Cuco,Cândido dos Reis,913.51,2587,1386,3974,0,0,0,42,42,84,0.2484304671460691,0.1331070604139311,0.19076876378000007
59,Cândido dos Reis,Pias,916.73,2418,1340,3759,0,0,0,44,42,86,0.22168022260818773,0.12867580705809942,0.17625946152558647
60,Pias,Araújo,1258.13,2306,1304,3610,0,0,0,50,42,92,0.1859937796074072,0.12524951444334878,0.15826270203251097
61,Araújo,Custió,651.69,2226,1284,3511,0,0,0,63,42,105,0.14251365414757808,0.12333093986099915,0.13484056843294653
62,Custió,Parque de Maia,1418.51,2099,1192,3291,0,0,0,63,42,105,0.1343694044452463,0.1144488436806637,0.1264011801394133
63,Parque de Maia,Forum,824.81,1818,1077,2896,0,0,0,59,42,101,0.1242868252477861,0.10345083993326629,0.1156223561070947
64,Forum,Zona Industrial,1119.4,773,497,1270,0,0,0,42,42,84,0.07424900133651402,0.04773110381152501,0.060990052574019515
65,Zona Industrial,Mandim,1194.23,706,433,1139,0,0,0,42,42,84,0.06783929458944295,0.04160227607839202,0.05472078533391749
66,Mandim,Castêlo da Maia,1468.1,693,404,1097,0,0,0,42,42,84,0.0665495744623031,0.03882789901312045,0.052688736737711774
67,Castêlo da Maia,ISMAI,702.48,344,211,556,0,0,0,42,42,84,0.03302929940564299,0.02035330261136712,0.026691301008505055
68,Santo Ovídio,D. João II,463.71,1160,3008,4169,84,86,170,0,0,0,0.06398809523809522,0.16196674286468338,0.11355376403742806
69,D. João II,João de Deus,716.25,1714,4290,6005,84,84,168,0,0,0,0.09448596755133508,0.23649414495994522,0.16549005625564014
70,João de Deus,C.M.Gaia,405.01,3424,6920,10345,84,84,168,0,0,0,0.18875296032360492,0.3814172798184785,0.2850851200710417
71,C.M.Gaia,General Torres,488.39,3848,8040,11888,84,84,168,0,0,0,0.21211669369296096,0.44313790355967486,0.3276272986263179
72,General Torres,Jardim do Morro,419.98,4156,9025,13181,84,84,168,0,0,0,0.22905903997455293,0.4974258481856997,0.36324244408012635
73,Jardim do Morro,São Bento,795.7,5043,9465,14509,84,78,162,0,0,0,0.27799035932838345,0.5618004002425337,0.4146396382870484
74,São Bento,Aliados,443.38,8923,10417,19341,86,80,166,0,0,0,0.48039751081905024,0.6028678085674295,0.539419341059233
75,Aliados,Trindade,450.27,11195,10755,21951,87,84,171,0,0,0,0.5957760751228838,0.5927879233092276,0.5943082110740702
76,Trindade,Faria Guimaraes,555.34,9347,7453,16800,93,84,177,0,0,0,0.4653299833835402,0.4107851320478505,0.4394442912242299
77,Faria Guimaraes,Marques,621.04,8596,7205,15801,84,84,168,0,0,0,0.4737935857767982,0.3971218872423464,0.4354577365095723
78,Marques,Combatentes,702.75,6477,5829,12306,84,84,168,0,0,0,0.35700955016142594,0.3212768988252751,0.33914322449335055
79,Combatentes,Salgueiros,471.25,5219,5278,10497,84,84,168,0,0,0,0.28767426125076445,0.29090742228454736,0.2892908417676559
80,Salgueiros,Polo Universitario,775.36,4419,4925,9344,84,84,168,0,0,0,0.24357945763662062,0.27145825060976797,0.2575188541231943
81,Polo Universitario,I.P.O.,827.64,3401,4003,7404,84,84,168,0,0,0,0.18745373378810498,0.22064294510817256,0.2040483394481388
82,I.P.O.,Hospital São João,351.77,2043,2224,4268,88,84,172,0,0,0,0.10749980117377883,0.12263007054673719,0.11488900249545618
83,Verdes (E) ,Botica,683.54,888,1987,2876,43,42,85,0,0,0,0.09570833363196168,0.21912877115426582,0.15669254981945316
84,Botica,Aeroporto,649.66,735,1917,2653,43,42,85,0,0,0,0.07914908573930912,0.2114197530864197,0.14450635666376377
