,A,B,Distance,PassagersAtoB,PassagersBtoA,PassagersTotal,EurotramAtoB,EurotramBtoA,EurotramTotal,TraintramAtoB,TraintramBtoA,TraintramTotal,OccupancyAtoB,OccupancyBtoA,OccupancyTotal
0,Fânzeres,Venda Nova,440.45,10342,13780,24123,2235,2198,4433,0,0,0,0.02142472450078712,0.029026072941808832,0.02519367642349538
1,Venda Nova,Carreira,583.47,19265,25644,44910,2238,2199,4437,0,0,0,0.039853864860417254,0.053990890942339546,0.04686024763124149
2,Carreira,Baguim,786.02,29370,35939,65309,2237,2199,4436,0,0,0,0.0607839933646407,0.07566449133236122,0.06816050712276005
3,Baguim,Campainha,751.7,36388,40750,77138,2239,2199,4438,0,0,0,0.07524063403221377,0.0857937068742453,0.08046961266664986
4,Campainha,Rio Tinto,859.99,50765,52895,103661,2237,2199,4436,0,0,0,0.10506332002757691,0.11136352985891204,0.10818644027534653
5,Rio Tinto,Levada,452.83,55969,60505,116474,2237,2199,4436,0,0,0,0.11583240241655984,0.12738414060038744,0.12155879382012992
6,Levada,Nau Vitória,1111.62,71962,75560,147522,2238,2200,4438,0,0,0,0.1488657593639864,0.15900689252924163,0.15389290964870056
7,Nau Vitória,Nasoni,499.02,75589,77780,153370,2238,2200,4438,0,0,0,0.15636835181293962,0.1636798809184911,0.15999281419063527
8,Nasoni,Contumil,650.0,78193,79452,157646,2238,2200,4438,0,0,0,0.16175550096935246,0.16719764425943326,0.16445327366835602
9,Contumil,Estádio do Dragão,619.19,92766,93912,186678,2238,2200,4438,0,0,0,0.1919004044821726,0.19762663752581291,0.19473900581070092
10,Estádio do Dragão,Campanhã,1166.02,166190,163308,329499,4122,4013,8135,2120,2208,4328,0.11735709750334729,0.11546217583135855,0.11641021240673993
11,Campanhã,Heroismo,950.92,335658,321318,656976,5011,4941,9952,3811,3821,7632,0.16555271721153955,0.15947379515460003,0.16252276021323225
12,Heroismo,24 de Agosto,571.9,360802,346043,706846,5011,4943,9954,3811,3821,7632,0.17795425226156242,0.1717083920993186,0.1748407524590668
13,24 de Agosto,Bolhão,680.44,468632,419166,887798,5011,4943,9954,3811,3821,7632,0.23113740970922145,0.20799253111688995,0.21959991558445366
14,Bolhão,Trindade,451.8,560981,522089,1083071,5009,4943,9952,3811,3823,7634,0.2767448967793465,0.2589999334073053,0.2678971702157882
15,Trindade,Lapa,857.4300000000001,639058,727718,1366777,5316,5292,10608,3818,3827,7645,0.3050225411752468,0.3478297177505695,0.3264110401276092
16,Lapa,Carolina Michaelis,460.97,629816,720668,1350484,5316,5292,10608,3822,3829,7651,0.300468770584659,0.34437827570844753,0.32240545104462337
17,Carolina Michaelis,Casa da Música,627.48,593223,682021,1275245,5313,5294,10607,3822,3830,7652,0.2830988525049919,0.32580485015594735,0.3044410443520858
18,Casa da Música,Francos,871.87,535735,566544,1102279,5312,5294,10606,3822,3830,7652,0.25569082380956965,0.2706408063976426,0.26316241721156414
19,Francos,Ramalde,965.03,493889,519851,1013740,5310,5294,10604,3822,3830,7652,0.2357672911439848,0.24833533147166809,0.2420491026821576
20,Ramalde,Viso,621.15,468633,495000,963633,5312,5294,10606,3822,3830,7652,0.22366478717978203,0.23646396445654036,0.2300614667697823
21,Viso,Sete Bicas,743.81,445838,465342,911180,5312,5296,10608,3822,3830,7652,0.21278541758947944,0.2222502276777531,0.21751615969250518
22,Sete Bicas,Sra da Hora,674.5,396470,418311,814782,5314,5298,10612,3822,3830,7652,0.18918488505313996,0.19974668505463544,0.1944639297573258
23,Sra da Hora,Vasco da Gama,824.48,134914,140490,275405,2791,2730,5521,0,0,0,0.22379236582830037,0.23824888251156426,0.2309407611453282
24,Vasco da Gama,Estádio do Mar,661.6,130826,133601,264427,2790,2731,5521,0,0,0,0.21708870355807927,0.22648324189895747,0.2217357755031867
25,Estádio do Mar,Pedro Hispano,786.97,125975,130325,256300,2790,2731,5521,0,0,0,0.20903959169071837,0.22092910952891334,0.21492082212290645
26,Pedro Hispano,Parque de Real,656.68,113733,119489,233222,2790,2731,5521,0,0,0,0.18872464517619233,0.20255994053568935,0.19556836762263072
27,Parque de Real,C. Matosinhos,723.67,105991,111252,217244,2790,2731,5521,0,0,0,0.17587944548098433,0.18859647347353192,0.18217000940919437
28,C. Matosinhos,Matosinhos Sul,616.61,74870,78447,153318,2789,2732,5521,0,0,0,0.12428281712711352,0.13293645374438,0.12856496442622092
29,Matosinhos Sul,Brito Capelo,535.72,37025,40774,77799,2788,2731,5519,0,0,0,0.06148259515157006,0.06912180096309198,0.06526274935908344
30,Brito Capelo,Mercado,487.53,18056,21747,39804,2795,2738,5533,0,0,0,0.029908348456366536,0.03677299374247325,0.03330531191079636
31,Mercado,Sr. de Matosinhos,708.96,3937,4606,8543,2786,2729,5515,0,0,0,0.006542621718288463,0.007813878370858951,0.00717168054056677
33,Fonte do Cuco,Custoias,689.2,135819,166267,302087,1639,1633,3272,2124,2189,4313,0.15420425784444183,0.18564963103787313,0.17005815152012596
34,Custoias,Esposade,1779.24,132472,163732,296204,1639,1631,3270,2124,2188,4312,0.1504043819842715,0.1829571358778694,0.1668104056023112
35,Esposade,Crestins,2035.56,130135,161722,291857,1639,1631,3270,2124,2188,4312,0.14775099643148965,0.18071151728648155,0.1643625275289012
36,Crestins,Verdes,591.8199999999999,128355,159086,287442,1639,1633,3272,2124,2188,4312,0.1457299775943452,0.17768081249232706,0.1618364991556166
37,Verdes,Pedras Rubras,960.78,102270,111911,214181,0,0,0,2124,2188,4312,0.19415225805555764,0.20624049508875583,0.20028608519577976
38,Pedras Rubras,Lidador,1147.58,90061,97434,187496,0,0,0,2124,2188,4312,0.1709750155225978,0.1795623817059713,0.17533242674922608
39,Lidador,Vilar do Pinheiro,1987.51,86207,93351,179559,0,0,0,2124,2188,4312,0.1636580300651023,0.17203807997587683,0.167910244630217
40,Vilar do Pinheiro,Modivas Sul,2037.38,83447,90173,173621,0,0,0,2124,2188,4312,0.15841927707594844,0.16618041603008826,0.16235744313152772
41,Modivas Sul,Modivas Centro,1051.08,82413,88991,171405,0,0,0,2124,2188,4312,0.15645527636251313,0.16400300750045924,0.16028515477852104
42,Modivas Centro,Modivas Norte,852.51,81723,88077,169801,0,0,0,2122,2188,4310,0.15529280479591193,0.16231728710582236,0.15885882969013093
43,Modivas Norte,Mindelo,1834.12,75225,82109,157335,0,0,0,2122,2188,4310,0.14294499624933443,0.15131907096067657,0.14719615065035918
44,Mindelo,Espaço Natureza,776.86,71705,77822,149527,0,0,0,2122,2188,4310,0.1362560323970815,0.14341858553554973,0.13989214986041526
45,Espaço Natureza,Varziela,1539.0,71056,77279,148335,0,0,0,2122,2188,4310,0.13502290434883066,0.14241723929751676,0.13877668738078544
46,Varziela,Árvore,858.71,66180,72085,138266,0,0,0,2122,2189,4311,0.12575814741317135,0.13278485986929203,0.12932610695073762
47,Árvore,Azurara,664.57,65822,71632,137455,0,0,0,2122,2189,4311,0.12507751502684955,0.1319518649212648,0.1285681093016988
48,Azurara,Santa Clara,1218.09,65461,71301,136762,0,0,0,2122,2189,4311,0.12439037688168979,0.1313413581170332,0.12791988231527057
49,Santa Clara,Vila do Conde,670.57,64148,69615,133764,0,0,0,2122,2189,4311,0.12189682449501624,0.12823571519316693,0.12511552821532518
50,Vila do Conde,Alto de Pega,730.41,45881,50845,96726,0,0,0,2121,2189,4310,0.08722649015438957,0.0936595684049177,0.09049377746074828
51,Alto de Pega,Portas Fronhas,671.05,43157,48094,91252,0,0,0,2121,2189,4310,0.0820473596362594,0.08859290348102031,0.08537176693931779
52,Portas Fronhas,São Brás,562.21,33763,37931,71694,0,0,0,2121,2190,4311,0.06418795085881238,0.06983987632716777,0.06705914472930607
53,São Brás,Póvoa de Varzim,624.94,31838,35827,67665,0,0,0,2125,2192,4317,0.0604144673780341,0.06590497704261832,0.06320232866707015
55,Fonte do Cuco,Cândido dos Reis,913.51,119906,123308,243214,889,930,1819,1702,1620,3322,0.19524911534540987,0.20461304571657454,0.19988690669200138
56,Cândido dos Reis,Pias,916.73,114646,117960,232607,889,930,1819,1702,1620,3322,0.1866845417566656,0.19574024940767193,0.19116967576731886
57,Pias,Araújo,1258.13,111439,114829,226268,889,931,1820,1702,1620,3322,0.18146153192558145,0.19047539689765222,0.18592674946611035
58,Araújo,Custió,651.69,108385,110396,218782,889,931,1820,1700,1618,3318,0.1766320978508926,0.18327346559723445,0.17992202130028542
59,Custió,Parque de Maia,1418.51,103587,104989,208576,889,931,1820,1700,1618,3318,0.1688119448910211,0.17429666671133248,0.1715289025448083
60,Parque de Maia,Forum,824.81,90168,89436,179604,889,931,1820,1700,1616,3316,0.14694395438075705,0.14859858164014975,0.1477632636465393
61,Forum,Zona Industrial,1119.4,43781,44246,88027,513,428,941,1029,1006,2035,0.11962027670532444,0.12940103777887454,0.12434442453570095
62,Zona Industrial,Mandim,1194.23,40010,40310,80320,513,428,941,1029,1006,2035,0.109317309341869,0.11788901783901859,0.1134574798045681
63,Mandim,Castêlo da Maia,1468.1,37191,37353,74544,513,428,941,1029,1006,2035,0.10161525582192742,0.10924100553078614,0.10529852429880712
64,Castêlo da Maia,ISMAI,702.48,23247,22299,45546,513,428,941,1029,1006,2035,0.06351642395096715,0.06521395816761034,0.06433633996018566
65,Santo Ovídio,D. João II,463.71,142198,116195,258393,6403,6442,12845,0,0,0,0.10281494206997879,0.08350543755611024,0.09313087604597403
66,D. João II,João de Deus,716.25,193353,173358,366712,6403,6442,12845,0,0,0,0.13980279701697837,0.1245863998280768,0.13217149840343972
67,João de Deus,C.M.Gaia,405.01,291983,274366,566350,6400,6442,12842,0,0,0,0.21121515713502997,0.19717716335727262,0.204173204486197
68,C.M.Gaia,General Torres,488.39,338210,313812,652022,6400,6442,12842,0,0,0,0.24465440364409957,0.2255256617130423,0.2350587522253275
69,General Torres,Jardim do Morro,419.98,375776,351964,727741,6400,6442,12842,0,0,0,0.27182931197028726,0.2529439546482221,0.2623557508529579
70,Jardim do Morro,São Bento,795.7,386137,368509,754647,6400,6442,12842,0,0,0,0.2793243297906767,0.26483441842757793,0.27205567934673636
71,São Bento,Aliados,443.38,449634,449599,899234,6398,6444,12842,0,0,0,0.32535832236582835,0.32301073658323726,0.3241803249524179
72,Aliados,Trindade,450.27,476823,476318,953142,6398,6444,12842,0,0,0,0.34503193708001584,0.342206749965186,0.3436142836173182
73,Trindade,Faria Guimaraes,555.34,422171,410005,832177,6442,6390,12832,0,0,0,0.3033993601163841,0.2970540167712341,0.3002395452803875
74,Faria Guimaraes,Marques,621.04,401148,392643,793791,6442,6390,12832,0,0,0,0.2882904544905123,0.2844748036652656,0.28639036029059595
75,Marques,Combatentes,702.75,322503,308246,630749,6442,6390,12832,0,0,0,0.231771222166203,0.22332798664869788,0.2275667119607122
76,Combatentes,Salgueiros,471.25,281984,267605,549590,6442,6390,12832,0,0,0,0.20265178389746444,0.19388359701448463,0.19828545642066883
77,Salgueiros,Polo Universitario,775.36,254485,240581,495066,6442,6390,12832,0,0,0,0.182889089336465,0.17430411401500423,0.17861399641999567
78,Polo Universitario,I.P.O.,827.64,196940,194194,391134,6434,6382,12816,0,0,0,0.1417101742946205,0.14087218916594801,0.14129288176253654
79,I.P.O.,Hospital São João,351.77,89142,104609,193751,6436,6384,12820,0,0,0,0.06412304628914346,0.07586167386057739,0.06996855318587
80,Verdes (E) ,Botica,683.54,27641,49266,76907,1639,1635,3274,0,0,0,0.07807666840053676,0.13950187504052108,0.10875174868653992
81,Botica,Aeroporto,649.66,24113,45317,69431,1639,1633,3272,0,0,0,0.06811195423747679,0.1284786010750493,0.09823992926368583
82,Sra da Hora,Fonte do Cuco,687.03,266331,293673,560004,2525,2563,5088,3827,3810,3827,0.1817705259079638,0.19757448552615878,0.18972104478517965
